###############################
#P.......#........#..#..#..#..#
####..#..#######..#..#..#..#..#
#.....#.......................#
#..#..#..#..################..#
#..#..#..#........#...........#
###################..#..#..#..#
#..#..#........#.....#..#..#..#
#..#..#######..##########..####
#.....#.....#.....#..#........#
#..#..####..#..#..#..#..#..#..#
#..#...........#.....#..#..#..#
####..#..#..####..##########..#
#.....#..#..#..#.....#........#
#..#..####..#..#..#######..####
#..#.....#.....#........#.....#
#############..#..####..#..####
#..#..#.....#..#.....#........#
#..#..#..#..####..#############
#........#...................X#
###############################